###############
#.............#
#.##.##.##.##.#
#.##.##.##.##.#
#.##.##.##.##.#
###############
