####################
#.##.##.##.##.##.###
#.##.##.##.##.##.###
#.##.##.##.##.##.###
#.##.##.##.##.##.###
#.##.##.##.##.##.###
#.##.##.##.##.##.###
#.##.##.##.##.##.###
#.##.##.##.##.##.###
#.##.##.##.##.##.###
#.##.##.##.##.##.###
#.##.##.##.##.##.###
#.##.##.##.##.##.###
#.##.##.##.##.##.###
#.##.##.##.##.##.###
#.##.##.##.##.##.###
#.##.##.##.##.##.###
#................###
#................###
####################
