######
#....#
#.##.#
#.##.#
#.##.#
######
